Acre,Land_Planting,Strate_Fertilizer,Liquid_Fertilizer,Fungicide,Insecticide,Others,Total,Area ,KG
1,48000,156640,9872,47372,25538,9050,296472,ampara,4971
1,44000,158900,9932,47600,21638,9950,292020,bakamuna,2313
1,46000,157250,9870,49902,23638,9050,295710,dehiaththakandiya,1793
1,47000,130200,11630,48030,24600,11000,272460,girithale,4600
1,49200,145806,8950,49560,27650,9530,290696,Kandakatiya,1238
1,52000,159560,9600,48600,22660,12605,305025,kanthale,3356
1,51800,139000,10400,51200,26450,9280,288130,mahiyanganaya,1718
1,45700,148400,15600,50300,28650,13560,302210,medirigiriya,6798
1,48820,150742,8946,48043,26411,9706,292668,monaragala,205
1,46460,150902,11884,48007,28343,12461,298057,morawewa,1015
1,41700,151707,8065,48715,25728,11447,287362,nikaweratiya,1149
1,50000,151864,8524,49480,23072,10107,293047,girithale,9785
1,46200,148207,10090,48477,25257,12424,290655,kanthale,2231
1,51460,154795,12482,50370,30103,10475,309685,mahiyanganaya,1692
1,44260,147717,11375,49765,28335,10247,291699,ampara,4650
1,48830,150403,11946,51821,25300,11377,299677,dehiaththakandiya,2149
1,49200,147245,11407,50024,23543,10660,292079,mahiyanganaya,1195
1,45800,148465,10693,48512,22548,7304,283322,monagala ,1716
1,49250,142663,9160,50052,24220,6857,282202,ampara,3013
1,50800,167441,8912,47742,22592,8797,306284,ampara,3886
1,47205,158927,11782,48866,22589,12028,301397,monaragala,960
1,45000,154507,13152,49302,29541,10674,302176,ampara,2313
1,48780,141176,11009,48603,24447,7650,281665,kanthale,3266
1,47900,155816,10752,48831,22388,10723,296410,ampara,3360
1,48200,145589,8426,47411,22624,10959,283209,dehiaththakandiya,1934
1,45490,154410,10261,46519,23156,11953,291789,mahiyanganaya,2352
1,48530,145606,11101,48570,29096,12661,295564,ampara,3592
1,44480,156170,12323,47812,24227,9141,294153,kanthale,3270
1,48890,151726,13544,49127,27095,11514,301896,ampara,4749
1,46400,155685,11553,48896,29656,11062,303252,bakamuna,2977
1,49050,158321,13713,48307,23996,8209,301596,dehiaththakandiya,4126
1,47237,138929,12294,48114,27133,10162,283869,girithale,1457
1,46698,138626,12517,50383,28034,12844,289102,Kandakatiya,2368
1,45210,154568,9302,49520,26907,11160,296667,kanthale,3794
1,48852,156693,8485,48110,24813,9406,296359,mahiyanganaya,1975
1,47360,144497,15029,49072,26515,9829,292302,medirigiriya,5963
1,44490,138851,11042,47745,25872,9682,277682,monaragala,2494
1,46000,154880,15175,48933,25992,11907,302887,morawewa,4576
1,46500,143138,12859,50450,24275,12210,289432,nikaweratiya,3861
1,49600,161632,12385,47830,25288,10255,306990,girithale,2146
1,44865,143799,9968,52548,23438,11719,286337,kanthale,1367
1,49570,179042,11027,49803,22703,14206,326351,mahiyanganaya,2657
1,51680,137546,9240,49684,26512,9916,284578,ampara,4321
1,44862,141569,7101,48711,23320,13779,279342,dehiaththakandiya,2693
1,45731,153463,13069,49979,21284,12550,296076,mahiyanganaya,3871
1,45415,150374,8320,49968,24027,9316,287420,monagala,3689
1,45550,142195,10629,48363,21293,9912,277942,ampara,4356
1,46765,153242,10337,48794,24092,11968,295198,ampara,2917
1,50822,150285,7894,47829,25862,9696,292388,monaragala,2153
1,48310,152897,11858,50707,26636,10297,300705,ampara,3854
1,45728,151767,9221,49727,27946,7103,291492,kanthale,2923
1,48706,147245,9171,47900,28117,9721,290860,ampara,3756
1,48370,159889,9341,49739,26075,11431,304845,dehiaththakandiya,1489
1,47678,160355,12220,50612,26509,10144,307518,mahiyanganaya,1538
1,48390,133215,12085,49394,22668,11730,277482,ampara,4721
1,49115,155516,8471,47850,24422,10878,296252,ampara,3295
1,47080,143185,9769,50928,25984,11754,288700,bakamuna,4098
1,49030,147682,11691,47622,24320,9815,290160,dehiaththakandiya,3942
1,44101,149379,10793,50630,23790,12786,291479,girithale,2716
1,48785,148796,13279,51884,26675,10971,300390,Kandakatiya,3896
1,48605,146601,9904,47384,23686,8852,285032,kanthale,4785
1,49770,157153,7295,47896,27099,9008,298221,mahiyanganaya,2537
1,50075,159014,12349,48316,24673,10047,304474,medirigiriya,1895
1,48431,141371,8571,49913,27630,12200,288116,monaragala,1236
1,46958,136653,9790,47264,20722,9872,271259,morawewa,4974
1,45960,128786,10762,50203,22588,10533,268832,nikaweratiya,4369
1,48216,158632,10956,49442,22318,10758,300322,girithale,2457
1,42264,168634,7384,48107,26750,12731,305870,kanthale,2149
1,45403,165352,12285,49018,25164,9263,306485,mahiyanganaya,3296
1,47228,143724,7316,48095,25594,9048,281005,ampara,1947
1,49520,143756,12637,48035,26070,10300,290318,dehiaththakandiya,3174
1,44873,143605,13151,50014,23509,12196,287348,mahiyanganaya,1978
1,45295,158530,9707,46716,26363,8206,294817,monagala,2456
1,49865,145389,9851,48905,24880,10430,289320,ampara,4387
1,51273,137216,12113,46468,27631,10858,285559,ampara,1984
1,43233,137912,9783,48809,26144,8722,274603,monaragala,4215
1,45360,148482,10708,47389,24623,12857,289419,ampara,2947
1,43261,147599,11492,49760,24371,9832,286315,kanthale,4597
1,52056,145737,9381,49074,21814,8139,286201,ampara,2169
1,46544,138668,11235,49131,24924,9368,279870,dehiaththakandiya,1796
1,47243,133293,9525,47782,25104,9784,272731,mahiyanganaya,3297
1,53539,156740,8637,48607,25422,10155,303100,ampara,4392
1,45800,158005,10565,50233,27112,9206,300921,ampara,2758
1,45277,145142,9473,46792,24698,9908,281290,bakamuna,2879
1,44628,149974,8351,51209,24203,9164,287529,dehiaththakandiya,2376
1,50475,139138,10402,47486,25109,9659,282269,girithale,4937
1,50104,158911,11588,47032,23242,8171,299048,Kandakatiya,3129
1,47447,146787,9244,48936,25571,11521,289506,kanthale,3864
1,44024,146047,9740,46807,26854,8854,282326,mahiyanganaya,1764
1,47631,148515,9625,49699,29228,11920,296618,medirigiriya,4398
1,51986,179803,9247,50909,23309,12376,327630,monaragala,2457
1,50217,142617,10520,45896,25388,11012,285650,morawewa,1278
1,51450,154441,13329,50868,24552,9925,304565,nikaweratiya,3145
1,50544,134889,11885,49728,29154,10612,286812,girithale,4786
1,51240,159407,7260,48609,22424,11502,300442,kanthale,1729
1,49860,138582,9981,49417,26210,11982,286032,mahiyanganaya,2543
1,45828,158589,10575,50745,23282,8954,297973,ampara,3745
1,48493,152860,10973,48416,23565,9272,293579,dehiaththakandiya,3126
1,46206,156480,10964,49736,27889,13481,304756,mahiyanganaya,2947
1,54600,135680,8560,50120,23400,9650,282010,monagala,3149
1,43364,153073,14481,50682,26985,11419,300004,ampara,3485
1,47884,138894,14590,50795,26401,9249,287813,ampara,3857
1,45977,165066,14653,48010,25799,12073,311578,monaragala,3147
1,41255,145248,8242,48085,24346,10917,278093,ampara,4972
1,44327,145813,8613,49697,27087,11929,287466,kanthale,3716
1,49342,143425,11715,49414,23201,12711,289808,ampara,2483
1,46984,162753,13859,48856,22672,12637,307761,dehiaththakandiya,1957
1,42728,165212,11355,49887,25315,11878,306375,mahiyanganaya,3784
1,47453,152204,12097,48623,28474,10763,299614,ampara,4879
1,48816,138267,10835,49408,25243,9578,282147,ampara,4297
1,47165,139888,8725,50087,22238,10786,278889,bakamuna,2479
1,43400,143738,9957,49339,27228,10610,284272,dehiaththakandiya,1396
1,50117,144615,13728,47965,27328,12924,296677,girithale,1987
1,49245,166550,11801,47349,23926,12952,311823,Kandakatiya,2475
1,48710,134428,12858,47782,28028,11943,283749,kanthale,4789
1,47459,155487,12947,49246,27767,12874,305780,mahiyanganaya,1237
1,41922,150866,11851,47282,26568,11667,290156,medirigiriya,3478
1,49845,167846,12122,49736,28469,10021,318039,monaragala,2417
1,47925,160617,10919,50401,24882,11712,306456,morawewa,3947
1,44553,150603,9381,47368,28191,11144,291240,nikaweratiya,1478
1,42420,146438,8449,49540,24093,11644,282584,girithale,2347
1,47025,140826,13154,47981,24598,11335,284919,kanthale,3147
1,42922,142815,10030,50621,28425,11616,286429,mahiyanganaya,2845
1,50810,135905,9871,49100,21558,9520,276764,ampara,3471
1,45738,169966,11200,50178,21840,10062,308984,dehiaththakandiya,4371
1,42282,148314,13728,48053,22780,9746,284903,mahiyanganaya,3298
1,44368,148406,14266,46162,23209,10915,287326,monagala,4729
1,44498,153511,12195,48294,22707,12858,294063,ampara,1297
1,42635,159245,13630,46107,24789,11162,297568,ampara,4176
1,49411,140127,11533,47586,23571,11146,283374,monaragala,2185
1,41548,147337,8505,47777,24749,11004,280920,ampara,4936
1,42835,150367,8384,50880,28188,12407,293061,kanthale,3296
1,43484,165773,8701,48895,26166,11328,304347,ampara,2785
1,45340,135283,12833,46608,20857,10922,271843,dehiaththakandiya,1947
1,47697,145246,11956,47617,23740,11573,287829,mahiyanganaya,1578
1,41701,135542,11577,48466,20777,10910,268973,ampara,4169
1,41217,133941,8198,47606,27157,9035,267154,ampara,4376
1,47543,145713,12835,50732,28735,12076,297634,bakamuna,3714
1,44507,154605,14655,48347,26972,12523,301609,dehiaththakandiya,3974
1,45770,154796,8290,46859,26748,12255,294718,girithale,4756
1,44673,141416,9386,46827,23533,10043,275878,Kandakatiya,2785
1,45608,133160,10265,48350,24957,12578,274918,kanthale,4986
1,47480,154396,8331,49993,21061,12491,293752,mahiyanganaya,2369
1,49335,145321,8182,47394,22000,11918,284150,medirigiriya,3178
1,44832,161557,11485,46709,28699,12355,305637,monaragala,2419
1,41006,164064,13781,49025,26141,12985,307002,morawewa,1235
1,44675,160883,12723,50592,24786,12437,306096,nikaweratiya,2486
1,50962,149287,12114,47270,21915,12507,294055,girithale,4326
1,42457,130188,10545,49767,23824,11694,268475,kanthale,2947
1,50551,151491,13831,47772,23506,12554,299705,mahiyanganaya,3768
1,47124,142795,12862,46816,22766,11250,283613,ampara,2869
1,42728,157257,8633,50859,24944,10963,295384,dehiaththakandiya,1497
1,44302,153027,8785,48993,28199,9465,292771,mahiyanganaya,3174
1,48410,154543,8696,49700,28447,12820,302616,monagala,2986
1,45175,137662,13567,49608,25386,12900,284298,ampara,4785
1,43730,137002,10455,50715,21748,12974,276624,ampara,4896
1,46364,153179,12937,48377,26447,10836,298140,monaragala,3716
1,46696,140596,9499,46890,28645,11146,283472,ampara,1597
1,42997,139931,14590,46697,26717,12405,283337,kanthale,3987
1,47686,159232,8443,47990,27076,12968,303395,ampara,2746
1,42975,167953,12020,49781,26293,9203,308225,dehiaththakandiya,2374
1,50133,151994,10404,46374,26612,11570,297087,mahiyanganaya,1276
1,43171,151842,10147,48747,24843,9679,288429,ampara,3876
1,44487,158493,9268,47014,24643,12369,296274,ampara,4327
1,43255,157122,14415,48979,21867,10767,296405,bakamuna,1874
1,42002,139784,10418,50941,20882,12111,276138,dehiaththakandiya,4785
1,41402,132923,10888,49182,25462,12446,272303,girithale,2796
1,44657,135083,11628,50884,20873,9531,272656,Kandakatiya,3169
1,41840,140858,9987,50414,26818,10473,280390,kanthale,1235
1,42456,138743,8472,49122,26722,12595,278110,mahiyanganaya,2437
1,47814,166854,13660,46715,24546,12978,312567,medirigiriya,4385
1,50649,165211,14270,46746,26087,10679,313642,monaragala,2784
1,49922,164368,8663,49885,22801,11157,306796,morawewa,4379
1,46863,166632,10442,47079,23940,9772,304728,nikaweratiya,3174
1,50667,151038,8292,50413,24869,10040,295319,girithale,3976
1,44928,135608,8763,48090,28641,10737,276767,kanthale,2376
1,49281,140822,13021,47949,25659,9098,285830,mahiyanganaya,1769
1,43303,159192,13140,47390,20241,10700,293966,ampara,4986
1,46665,141248,14758,46838,22388,10415,282312,dehiaththakandiya,2456
1,46616,154381,11378,49355,27667,11160,300557,mahiyanganaya,3175
1,42317,134070,13244,49316,24136,12987,276070,monagala,3967
1,41133,151636,8237,46790,23540,12452,283788,ampara,1876
1,44103,160481,14553,50331,21107,12681,303256,ampara,4758
1,49918,132673,9887,50769,24957,10503,278707,monaragala,2167
1,48496,163589,10132,50542,21454,11960,306173,ampara,3197
1,48543,132166,9877,50194,25837,10585,277202,kanthale,3874
1,45697,131487,10272,48609,24315,12228,272608,ampara,2587
1,43786,135513,14991,48831,26289,11227,280637,dehiaththakandiya,1597
1,45292,165790,10794,49671,26621,9092,307260,mahiyanganaya,1746
1,41959,158874,13209,48624,24037,11490,298193,ampara,4789
1,47710,152480,12084,46027,27919,9857,296077,ampara,4168
1,43897,152097,8105,46710,23623,10932,285364,bakamuna,2437
1,49535,160768,8702,49636,23194,10358,302193,dehiaththakandiya,2797
1,42717,162123,10597,47651,27432,9481,300001,girithale,1579
1,49489,139803,12894,47677,20316,9865,280044,Kandakatiya,2784
1,48073,144371,14381,46267,25433,11825,290350,kanthale,1956
1,45192,165936,14251,47527,20283,11082,304271,mahiyanganaya,4376
1,47332,160154,10584,47484,27873,10035,303462,medirigiriya,1947
1,48214,149926,11160,48033,26670,9650,293653,monaragala,2785
1,46850,162049,10431,50245,25047,12452,307074,morawewa,4756
1,46175,150807,13091,48050,23527,11304,292954,nikaweratiya,2367
1,47279,149435,12739,49155,21579,12842,293029,girithale,3796
1,48994,143816,9699,50637,28367,11895,293408,kanthale,2786
1,43159,138899,12822,48373,22602,10436,276291,mahiyanganaya,3876
1,41606,131528,14271,48163,21271,12961,269800,ampara,1947
1,47330,131857,13388,50327,20066,11860,274828,dehiaththakandiya,2976
1,45145,131026,9476,46298,28328,11543,271816,mahiyanganaya,2374
1,43736,154971,8681,46219,28771,10894,293272,monagala,2975
1,46284,169000,8189,46835,20545,12225,303078,ampara,3179
1,48328,130170,10079,48224,24724,9367,270892,ampara,4897
1,45713,163583,11785,50091,27667,11842,310681,monaragala,1376
1,48977,138385,11682,46177,24105,9266,278592,ampara,1379
1,43419,157524,13330,48627,28701,11773,303374,kanthale,4876
1,44920,139221,12520,49138,27211,12020,285030,ampara,3174
1,49447,142940,12639,50709,27111,10205,293051,dehiaththakandiya,3198
1,50473,156975,13610,46732,24351,10373,302514,mahiyanganaya,1749
1,44241,150787,13229,50470,22972,12939,294638,ampara,3786
1,46420,153312,9553,48745,21383,9022,288435,ampara,4285
1,47025,152818,8620,49275,27716,12181,297635,bakamuna,1785
1,49861,164875,8974,48180,25847,9630,307367,dehiaththakandiya,2379
1,50762,151116,14719,49639,25107,10533,301876,girithale,4198
1,45153,150991,10470,47733,28271,11605,294223,Kandakatiya,1786
1,45938,145444,12678,46976,25071,12055,288162,kanthale,2376
1,46360,146004,12860,48304,23505,10405,287438,mahiyanganaya,1974
1,47938,150177,8760,47303,24644,11876,290698,medirigiriya,1379
1,43778,166385,11303,50991,20452,10229,303138,monaragala,4179
1,42023,144026,9277,49668,24530,9656,279180,morawewa,4198
1,46370,169784,14867,46159,28021,12622,317823,nikaweratiya,2786
1,46727,158577,9327,49304,21437,9123,294495,girithale,1958
1,46896,146265,9702,49641,24605,10470,287579,kanthale,2379
1,46733,160013,10188,48512,23511,12995,301952,mahiyanganaya,3176
1,48007,139367,14646,46037,25898,10553,284508,ampara,2584
1,48637,159766,11086,48357,24752,11547,304145,dehiaththakandiya,2587
1,50059,168202,9534,47946,21983,11175,308899,mahiyanganaya,1987
1,44507,137102,9284,50630,21851,12752,276126,monagala,2796
1,49470,130229,13585,49864,21504,11641,276293,ampara,4175
1,41697,160200,11191,48531,20028,10351,291998,ampara,4978
1,48406,159434,14135,46941,25929,10362,305207,monaragala,2786
1,43102,130606,12057,48159,21963,9366,265253,ampara,1587
1,42643,161660,8067,48951,25133,10838,297292,kanthale,1589
1,42122,141685,14174,50675,25704,10399,284759,ampara,2786
1,44708,140620,11377,47135,22053,11562,277455,dehiaththakandiya,4176
1,44289,145755,11735,47808,27556,11942,289085,mahiyanganaya,2378
1,43498,165706,8043,48225,27820,10735,304027,ampara,4786
1,45404,142070,8913,46517,27198,10950,281052,ampara,1376
1,43097,142211,10286,48166,24322,10254,278336,bakamuna,2787
1,45887,142945,8180,48906,21004,12566,279488,dehiaththakandiya,2176
1,43383,156906,10668,47986,26482,9439,294864,girithale,1987
1,42579,151354,12785,46282,21398,11154,285552,Kandakatiya,2786
1,49130,169147,11432,49107,26027,9227,314070,kanthale,2796
1,48758,133154,8372,49630,20977,10668,271559,mahiyanganaya,1578
1,41781,130413,10350,48154,25140,11923,267761,medirigiriya,4978
1,43764,137217,10067,48769,20752,11053,271622,monaragala,2978
1,45801,158544,14735,46940,27691,11055,304766,morawewa,1987
1,42004,159942,10639,48862,23984,12833,298264,nikaweratiya,1987
1,42688,144633,12287,49340,20650,9705,279303,girithale,2796
1,44868,152263,9511,50582,22229,9030,288483,kanthale,1979
1,42790,157106,8640,48958,22935,12518,292947,mahiyanganaya,2378
1,43048,136720,8131,50027,25109,10950,273985,ampara,1876
1,44969,146842,14116,50208,20676,10322,287133,dehiaththakandiya,3178
1,42545,162537,8636,48966,27752,12198,302634,mahiyanganaya,2587
1,45459,135184,12873,46848,26083,11426,277873,monagala,2376
1,47078,151638,8236,49015,27997,12313,296277,ampara,4176
1,50779,157867,11581,48809,25009,9132,303177,ampara,4976
1,49703,156111,11024,46679,20544,11209,295270,monaragala,2785
1,43442,141511,8259,49254,28921,12955,284342,ampara,2586
1,43383,158006,13002,49994,23352,9981,297718,kanthale,2796
1,46607,149390,12557,46701,25402,10634,291291,ampara,1578
1,49099,164614,8508,49110,27590,12170,311091,dehiaththakandiya,2378
1,47557,140817,11261,48947,24909,9939,283430,mahiyanganaya,4178
1,48166,142616,13772,49999,25134,10258,289945,ampara,2786
1,41732,167274,8809,48699,25881,9740,302135,ampara,3178
1,45116,149415,9975,47013,20911,11202,283632,bakamuna,2796
1,45101,156343,14313,46621,21541,12186,296105,dehiaththakandiya,2378
1,41346,135866,14000,48298,21144,11194,271848,girithale,3176
1,50108,149523,14405,47542,28833,10677,301088,Kandakatiya,1578
1,47612,136839,13074,50694,23441,10054,281714,kanthale,4978
1,41280,167612,9010,50944,24588,11648,305082,mahiyanganaya,2786
1,50000,149170,13532,48028,26145,11051,297926,medirigiriya,2379
1,46427,147236,9874,46437,26646,11552,288172,monaragala,2786
1,42078,132537,11953,47343,23539,10335,267785,morawewa,1586
1,50992,154063,8733,47967,21840,12097,295692,nikaweratiya,2786
1,42883,156414,10585,47523,22120,12047,291572,girithale,2378
1,45519,157753,9171,47357,26523,9224,295547,kanthale,3176
1,47778,153230,12313,46224,21906,12197,293648,mahiyanganaya,2786
1,49406,147521,13622,49865,26040,11296,297750,ampara,2586
1,45433,142858,9064,50585,22320,11202,281462,dehiaththakandiya,2978
1,50731,166817,11347,48457,26892,9223,313467,mahiyanganaya,2379
1,42394,156430,12274,46490,21783,12220,291591,monagala,2787
1,50276,158021,14134,46819,25235,11144,305629,ampara,2787
1,42454,132164,13944,48141,20377,12224,269304,ampara,3176
1,50099,137400,8409,49419,23499,10771,279597,monaragala,4978
1,41845,154046,11305,46024,27707,11831,292758,ampara,1978
1,44595,160036,9635,47000,25287,12383,298936,kanthale,2378
1,48272,166095,14025,50047,22610,12038,313087,ampara,1587
1,50839,137700,12198,47954,22665,11763,283119,dehiaththakandiya,1978
1,48443,146711,8184,47913,28467,11276,290994,mahiyanganaya,4978
1,42814,138209,13918,49671,25217,11993,281822,ampara,2786
1,44189,168298,9625,47127,23765,11006,304010,ampara,2789
1,44072,144236,12604,47876,26062,12330,287180,bakamuna,1979
2,82500,268900,16560,93600,45000,18600,525160,nikaweratiya,2698
2,84600,283600,20640,95000,49050,26220,559110,ampara,9942
2,120000,306200,24900,117300,58000,24620,651020,bakamuna,4626
2,90000,276890,28320,92310,52600,19600,559720,dehiaththakandiya,3586
2,89653,316800,30000,94300,47300,22600,600653,girithale,9200
2,95730,297860,18900,120000,41520,27000,601010,Kandakatiya,2476
2,93120,349300,22300,98645,48000,20500,631865,kanthale,6712
2,106000,275400,26700,99200,46900,21500,575700,mahiyanganaya,3436
2,99630,325960,17230,100600,55640,17960,617020,medirigiriya,13596
2,100500,335870,19000,96800,51230,23480,626880,monaragala,410
2,114800,293200,21570,119600,42000,25000,616170,morawewa,2030
2,100997,300376,20730,93433,41148,27544,584228,nikaweratiya,2298
2,115260,349912,18807,106637,44733,21172,656521,girithale,19570
2,90843,273599,28312,107113,41148,18881,559896,kanthale,4462
2,86942,283518,18820,96913,46475,20686,553354,mahiyanganaya,3384
2,94834,330024,19547,94675,54681,22940,616701,ampara,9300
2,89855,341679,25491,95888,53065,25764,631742,dehiaththakandiya,4298
2,116606,308191,27750,99995,51153,22520,626215,mahiyanganaya,2390
2,103180,319949,13848,124492,46997,22777,631243,monagala,3432
2,101418,304937,22287,101477,50456,17074,597649,ampara,6026
2,108860,266602,20734,116943,44301,21037,578477,ampara,7772
2,122913,273601,19891,105843,43188,15889,581325,monaragala,1920
2,94665,299572,28428,121129,44976,20490,609260,ampara,4626
2,101665,282224,19712,125770,55493,17127,601991,kanthale,6532
2,97166,294160,17609,112298,42750,23121,587104,ampara,6720
2,106913,301688,20006,102738,50098,24649,606092,dehiaththakandiya,3868
2,91424,334910,19171,98696,49644,24579,618424,mahiyanganaya,4704
2,90212,273767,18051,110444,52478,21381,566333,ampara,9442
2,98528,272437,20604,101411,54732,22350,570062,ampara,6590
2,110208,375894,18095,108226,53713,24009,690145,bakamuna,5954
2,89896,265755,31185,100834,46022,21746,555438,dehiaththakandiya,7884
2,88736,280350,24797,107387,43720,22887,567877,girithale,2914
2,112766,310044,21243,119969,45527,21901,631450,Kandakatiya,4736
2,95231,299977,23827,99283,42585,20732,581635,kanthale,7588
2,96101,329676,22861,96906,46565,25782,617891,mahiyanganaya,3950
2,94678,309187,30885,99122,47919,26774,608565,medirigiriya,11926
2,96813,279630,18874,95900,48570,19194,558981,monaragala,4988
2,106723,316059,22503,89597,50763,23809,609454,morawewa,9152
2,98168,320124,23261,89406,53658,24460,609077,nikaweratiya,7722
2,99358,300536,18398,118139,51088,21271,608790,girithale,4292
2,95093,348411,22828,90823,50383,21089,628627,kanthale,2734
2,92491,257713,26683,90098,50209,20122,537316,mahiyanganaya,5314
2,93778,275729,29290,106842,50576,22102,578317,ampara,8642
2,89716,324226,17567,122733,56700,21653,632595,dehiaththakandiya,5386
2,106608,267292,21922,115534,40832,21991,574179,mahiyanganaya,7742
2,113156,311300,22578,98178,45892,24372,615476,monagala,7378
2,78825,279426,15058,111571,47352,21940,554172,ampara,8712
2,90940,290611,19910,83973,49388,21325,556147,ampara,5834
2,89394,288271,26431,87486,50208,22675,564465,monaragala,4306
2,98367,273799,23417,98999,45255,20928,560765,ampara,7708
2,101134,348700,25975,111239,57913,27723,672684,kanthale,5846
2,103725,264674,22034,103755,46934,25358,566480,ampara,7512
2,119980,317072,20269,96976,48047,26747,629091,dehiaththakandiya,3592
2,87252,327655,22699,98794,47519,25810,609729,mahiyanganaya,3076
2,102289,328126,15173,109087,58721,24507,637903,ampara,9442
2,93769,310574,28078,91350,54920,23343,602034,ampara,6590
2,114413,266532,19175,101392,52377,18438,572327,bakamuna,5758
2,108251,261952,26071,107301,45254,23229,572058,dehiaththakandiya,4752
2,96460,266024,16653,113664,56050,22914,571765,girithale,9874
2,87349,301962,23250,103021,44074,24712,584368,Kandakatiya,6258
2,108377,300000,26277,85318,59067,20460,599499,kanthale,7728
2,103731,302057,24443,99127,42306,19632,591296,mahiyanganaya,3528
2,109147,331225,19038,104655,37702,17950,619717,medirigiriya,8796
2,118250,313801,20643,94049,48183,22399,617325,monaragala,4914
2,105066,321739,19032,86742,54435,19756,606770,morawewa,2556
2,99428,313445,26012,115172,41090,25287,620434,nikaweratiya,6290
2,94726,277142,25755,112748,45669,24509,580549,girithale,9572
2,92589,252593,21200,117234,54928,23783,562327,kanthale,4478
2,93323,334326,19856,96022,53398,26851,623776,mahiyanganaya,5086
2,87233,230690,21954,104002,45779,28392,518050,ampara,7486
2,105362,281928,23990,105743,48637,27151,592811,dehiaththakandiya,6252
2,115387,308669,20889,105051,59770,23166,632932,mahiyanganaya,5894
2,101357,315222,19551,106041,49242,18829,610242,monagala,6298
2,91278,329325,18712,93024,48084,23222,603645,ampara,6970
2,84214,274254,26136,107676,47602,25397,565279,ampara,7714
2,88644,342758,14991,79678,43711,18637,588419,monaragala,6294
2,87712,283074,28927,114273,50276,21435,585697,ampara,9944
2,89988,284642,21165,92170,47266,19934,555165,kanthale,7432
2,96336,305186,29534,104510,45197,23764,604527,ampara,4966
2,101092,313541,18980,107227,53912,17933,612685,dehiaththakandiya,3914
2,105099,298784,23074,92271,43533,20432,583193,mahiyanganaya,7568
2,102312,269448,26189,94598,56403,25222,574172,ampara,9758
2,96341,242563,19501,100539,49861,23551,532356,ampara,8594
2,84496,313736,24449,87371,45429,21102,576583,bakamuna,4958
2,89230,331622,19074,73298,50943,16259,580426,dehiaththakandiya,2792
2,100624,340505,28397,120691,43273,21724,655214,girithale,3974
2,97217,323088,21285,84847,60672,23403,610512,Kandakatiya,4950
2,93094,280846,31201,88913,45360,22358,561772,kanthale,9578
2,93395,295285,21721,96764,53043,23835,584043,mahiyanganaya,2474
2,89828,339658,19674,106569,46443,23952,626124,medirigiriya,6956
2,111725,307286,34308,119331,46519,18388,637557,monaragala,4834
2,97793,321084,30072,95340,56042,21417,621748,morawewa,7894
2,98439,309416,23428,104199,48726,23387,607595,nikaweratiya,2956
2,101125,296142,29185,104285,43190,23541,597468,girithale,4694
2,109998,334956,20202,114101,54546,22908,656711,kanthale,6294
2,98443,331653,19079,102758,44773,24165,620871,mahiyanganaya,5690
2,95391,262563,27258,107278,45872,19816,558178,ampara,6942
2,92730,308145,21446,92655,46488,20931,582395,dehiaththakandiya,8742
2,92070,298350,16652,103828,51306,23690,585896,mahiyanganaya,6596
2,105245,294914,22646,97866,47176,21558,589405,monagala,9458
2,86255,302420,25116,100151,52316,20381,586639,ampara,2594
2,112016,319815,18819,108602,52537,25844,637633,ampara,8352
2,87066,269496,28942,99290,49323,18482,552599,monaragala,4370
2,115970,324745,21310,117289,47976,22842,650132,ampara,9872
2,100628,301128,25599,98265,41825,18714,586159,kanthale,6592
2,87311,297512,29124,101226,52801,18605,586579,ampara,5570
2,117842,298033,22647,98563,42667,22594,602346,dehiaththakandiya,3894
2,117192,264789,27225,103409,40457,21452,574524,mahiyanganaya,3156
2,89144,267110,18661,93188,57131,21512,546746,ampara,8338
2,103430,306150,20331,119407,46351,22731,618400,ampara,8752
2,102427,311980,20293,93652,52768,20509,601629,bakamuna,7428
2,87194,264920,19294,93671,47759,18459,531297,dehiaththakandiya,7948
2,100040,318355,20137,96185,49151,23969,607837,girithale,9512
2,106746,328604,23088,119053,42535,22879,642905,Kandakatiya,5570
2,99576,333947,28823,92357,53177,22296,630176,kanthale,9972
2,92187,330216,23871,111824,55208,24638,637944,mahiyanganaya,4738
2,85797,304177,16509,116886,42987,19555,585911,medirigiriya,6356
2,104716,265316,28928,92041,46437,21422,558860,monaragala,4834
2,84594,288190,19957,119256,43673,24113,579783,morawewa,2470
2,96262,282813,29370,110701,44632,25701,589479,nikaweratiya,6290
2,97521,313161,24332,112959,49535,21470,618978,girithale,8652
2,82755,310170,19072,117569,55266,20016,604848,kanthale,5894
2,108002,266470,24532,108067,49497,22133,578701,mahiyanganaya,7536
2,115870,302000,27502,107891,40091,19895,613249,ampara,5738
2,82609,314531,28769,117748,47355,25845,616857,dehiaththakandiya,2994
2,99889,260315,19876,105765,51697,20636,558178,mahiyanganaya,6348
2,96144,300668,27452,104410,41930,23062,593666,monagala,5972
2,100395,304225,21391,109746,55487,25947,617191,ampara,9570
2,113886,279376,20064,92859,45278,20499,571962,ampara,9792
2,104835,288538,26621,105658,51903,22021,599576,monaragala,7432
2,97331,265040,19372,94174,55335,21193,552445,ampara,3194
2,118029,284118,20659,110989,54013,24341,612149,kanthale,7974
2,94127,326026,23422,94407,57862,18448,614292,ampara,5492
2,83902,300418,27156,115738,41590,23455,592259,dehiaththakandiya,4748
2,95111,315340,21362,102355,43540,21730,599438,mahiyanganaya,2552
2,119638,289717,24281,112503,42112,21541,609792,ampara,7752
2,118665,282644,20833,107788,56385,19885,606200,ampara,8654
2,90743,337613,23429,110790,46705,23513,632793,bakamuna,7428
2,93508,327681,26970,100649,46744,25462,621014,dehiaththakandiya,9570
2,109985,330169,27827,100223,46414,25092,639710,girithale,5592
2,108170,323562,25424,110816,51680,24270,643922,Kandakatiya,6338
2,84009,278187,16918,99901,48611,18351,545977,kanthale,2470
2,91257,282971,20789,104679,55393,25656,580745,mahiyanganaya,4874
2,114864,265022,29242,107259,45959,23882,586228,medirigiriya,8770
2,99940,333231,25336,101726,40008,22553,622794,monaragala,4828
2,92050,314876,26760,113464,53535,24667,625352,morawewa,8758
2,106510,266441,16401,111557,47322,23957,572188,nikaweratiya,6290
2,101121,331782,20901,97781,42403,24654,618642,girithale,7952
2,86580,267018,24501,100805,41694,24374,544972,kanthale,4752
2,106928,286799,17296,93554,52576,20704,577857,mahiyanganaya,3538
2,96715,336943,24708,101003,55882,22813,638064,ampara,9972
2,103881,275863,29760,96390,56616,24544,587054,dehiaththakandiya,4912
2,103512,295557,26796,99389,52600,20895,598749,mahiyanganaya,6350
2,118592,297996,20277,110489,54401,21774,623529,monagala,7934
2,93280,263192,22310,103032,48014,23030,552858,ampara,3752
2,112608,329171,23448,96142,44968,24944,631281,ampara,9516
2,116144,277805,19123,105530,44150,23266,586018,monaragala,4334
2,105359,338058,28828,115769,41315,23038,652367,ampara,6394
2,88959,302459,28395,107971,44803,18918,591505,kanthale,7748
2,90125,260277,21454,110480,51913,18246,552495,ampara,5174
2,94232,339307,27611,96487,48696,21357,627690,dehiaththakandiya,3194
2,94773,265340,29468,107165,57106,25219,579071,mahiyanganaya,3492
2,110163,316062,20561,93709,47317,19678,607490,ampara,9578
2,110516,283664,17129,110049,54123,21470,596951,ampara,8336
2,103568,330002,26951,103413,54651,23530,642115,bakamuna,4874
2,87781,302381,21746,118769,44106,18604,593387,dehiaththakandiya,5594
2,93313,293332,24127,116103,48293,18436,593604,girithale,3158
2,114009,289612,23942,103576,48613,24799,604551,Kandakatiya,5568
2,88177,297018,28519,115045,49730,25494,603983,kanthale,3912
2,88586,328252,28154,114834,52702,21278,633806,mahiyanganaya,8752
2,93598,333619,29604,97639,57530,18946,630936,medirigiriya,3894
2,108742,318605,25444,96158,45330,22507,616786,monaragala,5570
2,104642,304327,19582,94364,56449,24359,603723,morawewa,9512
2,96828,277743,20951,107472,51707,25443,580144,nikaweratiya,4734
2,90870,262437,27983,114303,41470,18436,555499,girithale,4694
2,98244,299437,18427,95171,51970,24815,588064,kanthale,6292
2,109634,273083,21519,104326,45611,24407,578580,mahiyanganaya,7634
2,90900,260193,28048,95847,54339,21174,550501,ampara,3894
2,100575,294408,16487,92519,53669,19826,577484,dehiaththakandiya,5952
2,118245,334300,24967,95365,40569,20445,633891,mahiyanganaya,3944
2,88809,323325,29739,117367,50447,20539,630226,monagala,5950
2,99337,282236,29468,107253,46943,25401,590638,ampara,6558
2,83337,298600,29941,92858,46528,24118,575382,ampara,9794
2,116870,300914,26827,119195,46303,24676,634785,monaragala,2752
2,117953,305669,29231,98175,52702,20374,624104,ampara,2758
2,84607,329380,22034,107023,48774,20387,612205,kanthale,9752
2,108423,331307,16008,105878,50556,24958,637130,ampara,6348
2,86367,313847,25169,106710,55924,19126,607143,dehiaththakandiya,6396
2,90776,329834,20915,93556,50490,25480,611051,mahiyanganaya,3498
2,95480,261628,25200,116725,45026,20561,564620,ampara,7572
2,108341,307799,22724,113218,52117,19944,624143,ampara,8570
2,100421,317625,16559,98650,44162,25140,602557,bakamuna,3570
2,115351,334272,18402,101955,54971,21216,646167,dehiaththakandiya,4758
2,108062,262761,23877,115497,51810,21237,583244,girithale,8396
2,111448,293419,18007,107098,42494,25202,597668,Kandakatiya,3572
2,88731,322350,25076,111308,46495,23947,617907,kanthale,4752
2,117213,276503,17863,92241,52814,25966,582600,mahiyanganaya,3948
2,83999,329443,26863,99130,52742,18790,610967,medirigiriya,2758
2,82695,317100,20886,100417,53143,23067,597308,monaragala,8358
2,84357,304223,23916,105461,41937,23211,583105,morawewa,8396
2,103059,307486,17079,103229,41092,20577,592522,nikaweratiya,4756
2,94471,277415,23883,94349,44993,21923,557034,girithale,3916
2,112169,273832,18931,104724,42612,22847,575115,kanthale,4758
2,111855,288720,17135,101779,51227,18949,589665,mahiyanganaya,6352
2,88704,298132,16945,111459,47230,25035,587505,ampara,5168
2,118739,272579,26751,110959,41838,18407,589273,dehiaththakandiya,5174
2,96838,260653,25693,116444,55648,24471,579747,mahiyanganaya,3956
2,113489,303253,28715,111580,40044,21093,618174,monagala,5592
2,106172,272562,23459,108278,51299,19846,581616,ampara,8350
2,85358,293983,29060,102708,57162,24475,592746,ampara,9956
2,94420,270650,21454,96249,46904,24155,553832,monaragala,5570
2,84571,291273,25879,103417,40814,25958,571912,ampara,3174
2,111030,330903,18323,102723,46841,19465,629285,kanthale,3178
2,97232,337943,28900,108133,49287,19163,640658,ampara,5572
2,108218,277215,18492,98346,49294,25345,576910,dehiaththakandiya,8352
2,101734,335547,21705,106969,50034,20594,636583,mahiyanganaya,4756
2,115247,318240,18423,115143,44148,18849,630050,ampara,9572
2,109910,315629,18413,98159,42040,23823,607974,ampara,2752
2,118395,263277,25719,109304,49585,20623,586903,bakamuna,5574
2,85551,278538,28569,100257,48709,20150,561774,dehiaththakandiya,4352
2,107417,289902,29997,104751,40833,24204,597104,girithale,3974
2,85267,338364,22306,118916,54463,23670,642986,Kandakatiya,5572
2,88419,319993,19354,93975,41178,21154,584073,kanthale,3912
2,114928,330918,16529,103814,44805,25130,636124,mahiyanganaya,8752
2,116577,263857,20659,103513,56134,20656,581396,medirigiriya,3894
2,101088,276587,28400,103655,46821,18399,574950,monaragala,5570
2,85964,332379,19754,98720,49860,23330,610007,morawewa,9512
2,83201,282825,20709,92068,43984,21775,544562,nikaweratiya,4734
2,109325,273216,23746,95924,46837,21376,570424,girithale,4694
2,89857,337439,25809,95256,47431,25698,621490,kanthale,6292
2,110367,286987,20896,115866,43597,23133,600846,mahiyanganaya,7634
2,90444,331060,22484,114580,55305,21447,635320,ampara,3894
2,105987,294118,23264,116008,43059,22235,604671,dehiaththakandiya,5952
2,117428,310058,21605,103203,53773,25084,631151,mahiyanganaya,3944
2,94329,270071,22720,116323,46055,22319,571817,monagala,5950
2,84563,284211,25313,103624,51465,22631,571807,ampara,6558
2,89289,298076,18200,97597,44281,18924,566367,ampara,9794
2,100581,336424,29311,109880,43686,18307,638189,monaragala,2752
2,88279,306272,20742,102799,43953,20534,582579,ampara,2758
2,100119,272987,23089,104982,49973,18664,569814,kanthale,9752
2,87612,260510,24892,107893,51947,23563,556417,ampara,6348
2,104842,286924,19326,107837,49857,22562,591348,dehiaththakandiya,6396
2,110820,293358,27383,102104,44258,18602,596525,mahiyanganaya,3498
2,110469,329283,20581,97353,54295,23613,635594,ampara,7572
2,91921,268029,27230,98768,41677,23249,550874,ampara,8570
2,108147,292861,21556,103219,53637,22628,602048,bakamuna,3570
2,113720,273378,21109,103078,45206,23281,579772,dehiaththakandiya,4758
2,112914,300581,20753,116364,48747,22218,621577,girithale,8396
2,113148,302035,26602,106597,48174,21933,618489,Kandakatiya,3572
2,88788,263541,21185,105421,51663,24905,555503,kanthale,4752
2,114146,285711,28013,109470,44406,22299,604045,mahiyanganaya,3948
2,82740,312925,23935,114248,55297,23937,613082,medirigiriya,2758
2,84276,272399,21668,115950,48366,24092,566751,monaragala,8358
2,90310,273461,26212,108218,48819,18536,565556,morawewa,8396
2,96897,292473,16341,115227,43710,21672,586320,nikaweratiya,4756
2,88230,303879,16438,118530,40437,20640,588154,girithale,3916
2,103494,321445,20732,115040,56631,22338,639680,kanthale,4758
2,92981,326458,25365,101598,55176,22649,624227,mahiyanganaya,6352
2,90853,270813,16793,118681,49903,22929,569972,ampara,5168
2,88181,310818,22737,97958,48583,18043,586320,dehiaththakandiya,5174
2,93667,278351,19183,117702,53163,22891,584957,mahiyanganaya,3956
2,84685,315360,27905,96866,49466,25453,599735,monagala,5592
2,99895,293652,29839,97946,44116,25795,591243,ampara,8350
2,87471,292035,21480,100343,54780,21641,577750,ampara,9956
2,107046,309479,18588,108583,55480,23751,622927,monaragala,5570
2,112146,271877,28083,112893,46820,19941,591760,ampara,3174
2,113427,271082,19178,106867,54594,20355,585503,kanthale,3178
2,82094,294821,24100,106599,54612,21359,583585,ampara,5572
2,100042,311451,18073,105046,52850,21355,608817,dehiaththakandiya,8352
2,82230,279448,18760,119952,55551,23948,579889,mahiyanganaya,4756
2,88144,306470,19045,99533,52716,18286,584194,ampara,9572
2,95161,264169,27921,117846,48989,21571,575657,ampara,2752
2,102493,272509,25879,102707,49697,18375,571660,bakamuna,5574
2,116439,281318,24082,95008,54770,20345,591962,dehiaththakandiya,4352
2,119639,312959,16790,117944,45768,24872,637972,girithale,3974
2,82576,280635,22659,111131,45301,23269,565571,Kandakatiya,5572
2,100413,338300,18494,114059,41215,18591,631072,kanthale,3912
2,108544,262612,20224,118813,53369,25915,589477,mahiyanganaya,8752
2,109996,289451,29876,119398,51173,20276,620170,medirigiriya,3894
2,117134,313705,21221,95021,45602,25217,617900,monaragala,5570
2,114194,316475,17718,105611,54913,24162,633073,morawewa,9512
2,111099,322754,21833,107174,57654,19448,639962,nikaweratiya,4734
2,110545,318575,18030,106872,50842,18685,623549,girithale,4694
2,93394,319148,29967,106988,52425,21805,623727,kanthale,6292
2,108247,302881,29903,112290,54690,22817,630828,mahiyanganaya,7634
2,86219,275836,23571,104202,40866,19914,550608,ampara,3894
2,101447,307236,28615,108557,47428,20660,613943,dehiaththakandiya,5952
2,107844,271335,22394,115873,45135,25374,587955,mahiyanganaya,3944
2,118081,322305,18775,117933,48221,23340,648655,monagala,5950
2,85546,283861,24526,115589,46509,18296,574327,ampara,6558
2,118753,297898,25857,115861,56680,24741,639790,ampara,9794
2,87153,334423,17721,118801,54674,24297,637069,monaragala,2752
2,105879,315756,25475,96284,54808,18876,617078,ampara,2758
2,87592,272187,27111,93861,52106,19710,552567,kanthale,9752
2,88874,300206,27254,112543,51039,20301,600217,ampara,6348
2,88628,268174,16406,92316,47627,25383,538534,dehiaththakandiya,6396
2,83903,297800,25297,116129,46819,25998,595946,mahiyanganaya,3498
2,104397,283423,17725,101838,40389,22571,570343,ampara,7572
2,88159,287011,24726,92734,53722,25756,572108,ampara,8570
2,91490,317685,25401,118746,51576,25841,630739,bakamuna,3570
3,140950,415666,28650,152784,77688,37594,853332,nikaweratiya,14913
3,123640,406155,38266,149069,70631,34619,822380,mahiyanganaya,6939
3,120819,417994,25671,140046,83089,37124,824743,monagala ,5379
3,144299,458941,44824,143566,78878,35347,905855,ampara,13800
3,129012,505664,36873,141721,81193,35460,929923,bakamuna,3714
3,128024,483655,43078,141174,65379,34585,895895,dehiaththakandiya,10068
3,127314,497759,27658,145054,88736,31312,917833,girithale,5154
3,124572,447537,42130,151697,74586,35266,875788,Kandakatiya,20394
3,144132,477733,26595,145659,60934,33701,888754,kanthale,615
3,123358,427963,38181,138262,68703,32516,828983,mahiyanganaya,3045
3,142174,426528,41029,152465,76375,30172,868743,medirigiriya,3447
3,144270,457391,31181,145640,66969,38646,884097,monaragala,29355
3,149234,482586,38916,140667,71889,31990,915282,morawewa,6693
3,137870,498031,39987,138210,67457,37489,919044,nikaweratiya,5076
3,122848,408589,36863,141573,82288,38467,830628,girithale,13950
3,139349,507813,26359,144751,71389,35428,925089,kanthale,6447
3,133825,445518,24044,143113,60651,30403,837554,mahiyanganaya,3585
3,121041,404918,42860,143710,70056,30327,812912,ampara,5148
3,120976,468904,34952,138071,79172,33587,875662,dehiaththakandiya,9039
3,123070,412823,39667,144616,79137,37939,837252,mahiyanganaya,11658
3,127164,481420,28314,140640,77112,36773,891423,monagala ,2880
3,127623,405081,25384,151513,74768,29764,814133,ampara,6939
3,136559,413146,36099,152688,72821,34715,846028,ampara,9798
3,139726,404907,42773,144082,60076,35401,826965,monaragala,10080
3,120869,504052,32628,145241,80713,35869,919372,ampara,5802
3,138390,406091,39082,148538,68943,34631,835675,kanthale,7056
3,126515,508850,24316,145301,84425,38865,928272,ampara,10776
3,143462,466066,44922,142512,70839,31187,898988,dehiaththakandiya,9810
3,141295,450414,40120,150079,66138,32969,881015,mahiyanganaya,14247
3,142981,504988,30422,149156,65380,31855,924782,ampara,8931
3,137856,418638,36793,150713,77082,30945,852027,kanthale,12378
3,133746,430835,30206,148944,78472,29918,852121,ampara,4371
3,127223,455004,42783,139521,67400,32033,863964,bakamuna,7148
3,134719,464390,29345,142464,62171,31833,864922,dehiaththakandiya,9039
3,139309,394612,34149,140688,72558,31460,812776,girithale,11658
3,129115,497481,31649,141038,87347,37209,923839,nikaweratiya,14520
3,146523,428966,44286,147721,76422,36744,880662,mahiyanganaya,7020
3,148485,395719,32003,148452,67481,34606,826746,monagala,5280
3,120212,427167,36037,149883,65479,38236,837014,ampara,13740
3,144864,467641,38097,145990,85386,33570,915548,bakamuna,3660
3,146405,480072,25088,148147,61301,34270,895283,dehiaththakandiya,10140
3,125231,412059,42762,146434,66493,29750,822729,girithale,5220
3,142876,464826,29101,151618,75308,31141,894870,Kandakatiya,20460
3,133848,408853,35452,151662,88262,31357,849434,kanthale,600
3,131149,421069,38734,138122,75348,31705,836127,mahiyanganaya,3120
3,129105,467728,29960,145337,78591,35177,885898,medirigiriya,3480
3,125094,422395,34425,140329,70561,31875,824679,monaragala,29400
3,127055,414574,43624,144174,72883,37280,839590,morawewa,6780
3,145018,464265,43655,149789,62538,29951,895216,nikaweratiya,5160
3,131029,471402,31543,140482,63690,30836,868982,girithale,13860
3,123349,402238,30889,143111,86018,36623,822228,kanthale,6480
3,123039,422395,39567,140575,82304,36635,844515,mahiyanganaya,3540
3,132449,410339,25994,150236,77505,34938,831461,ampara,5160
3,123169,481985,42092,139229,72002,33551,892028,dehiaththakandiya,9000
3,131763,451820,35537,142117,63734,29269,854240,mahiyanganaya,11580
3,147770,432387,44015,147413,64099,34949,870633,monagala,2880
3,131270,412210,41318,142884,79827,34153,841662,ampara,6840
3,139782,456183,40200,141011,75355,30850,883381,ampara,9720
3,128667,451863,41938,149284,66369,29470,867591,monaragala,10020
3,146447,393507,24925,145043,75306,30845,816073,ampara,5880
3,121423,472749,25685,147241,82125,34426,883649,kanthale,7140
3,143911,398087,36289,150193,80637,32413,841530,ampara,10800
3,135054,429998,24364,145513,82937,32538,850404,dehiaththakandiya,9900
3,137571,447970,36322,143169,77559,29720,872311,mahiyanganaya,14160
3,124090,501176,30943,145440,83298,29916,914863,ampara,8850
3,132403,498686,39282,139202,88905,30249,928727,kanthale,12360
3,122582,404303,33597,144314,63194,32964,800954,ampara,4380
3,138089,410033,43197,147705,64434,30298,833756,nikaweratiya,14640
3,129606,464973,43374,147134,60081,32273,877441,mahiyanganaya,6780
3,147177,419913,27850,151478,85007,36136,867561,monagala,5460
3,140599,449057,40707,149875,73923,29663,883824,ampara,13620
3,140267,405089,38445,139593,67651,29845,820890,bakamuna,3690
3,149014,393898,30905,152451,74327,38452,839047,dehiaththakandiya,10110
3,148236,402127,33975,144193,66532,29279,824342,girithale,5070
3,131850,446973,27369,152892,81844,38523,879451,Kandakatiya,20490
3,138918,443138,40572,147186,86970,34055,890839,kanthale,630
3,126300,401667,24845,151309,70476,29503,804100,mahiyanganaya,3030
3,143087,498110,40672,150953,67928,38826,939576,medirigiriya,3510
3,122279,486957,24184,143747,63281,37989,878437,monaragala,29580
3,121501,504065,31183,147075,74215,34349,912388,morawewa,6510
3,141668,509637,27710,148035,83388,38669,949107,nikaweratiya,5010
3,127467,428071,28831,151468,66688,33168,835693,girithale,13830
3,145331,427498,33789,141956,73398,35459,857431,kanthale,6480
3,129482,450511,26460,140912,82740,32225,862330,mahiyanganaya,3360
3,122614,506999,44726,146602,73141,34427,928509,ampara,5220
3,148027,487479,40995,143676,80104,35646,935927,dehiaththakandiya,9120
3,127628,483716,40040,144047,85445,35122,915998,mahiyanganaya,11430
3,148392,507365,35467,141208,76800,38624,947856,monagala,2790
3,123309,417150,32536,146419,60794,33470,813678,ampara,6900
3,132455,469098,40976,143334,76740,34738,897341,ampara,9690
3,129108,462192,27876,142641,82932,35071,879820,monaragala,9990
3,134857,414274,29648,145273,64107,36438,824597,ampara,5760
3,140830,459575,37709,149833,75001,37850,900798,kanthale,6930
3,147332,494301,37960,141626,71579,30786,923584,ampara,10650
3,131954,429917,38556,143138,82287,29692,855544,dehiaththakandiya,9870
3,125329,410324,43784,150680,85995,32368,848480,mahiyanganaya,14040
3,132130,445134,40969,149456,73761,37932,879382,ampara,8670
3,131641,496800,39278,139487,81553,31326,920085,kanthale,12210
3,126865,454942,31327,138811,80764,30125,862834,ampara,4290
3,141960,411180,25548,145483,68330,38153,830654,nikaweratiya,14580
3,124249,394412,33772,139882,82638,35363,810316,mahiyanganaya,6900
3,136192,471094,43764,142777,72634,33818,900279,monagala,5340
3,133776,484949,31440,148448,68422,30350,897385,ampara,13500
3,134527,500787,30544,151869,73981,33397,925105,bakamuna,3690
3,144910,443786,43357,143668,82801,35696,894218,dehiaththakandiya,10050
3,140155,471904,41148,142676,85428,30273,911584,girithale,5220
3,142411,493005,28351,138883,75727,38021,916398,Kandakatiya,20340
3,149166,390150,41080,151380,81158,33493,846427,kanthale,630
3,151901,490896,36918,151947,62879,35942,930483,mahiyanganaya,3000
3,124564,413482,33181,148852,79698,30417,830194,medirigiriya,3420
3,152651,445425,25472,139240,75667,38343,876798,monaragala,29460
3,129609,506872,25667,140949,88998,36097,928192,morawewa,6780
3,123600,437752,29941,143412,76509,31643,842857,nikaweratiya,5070
3,151871,486375,40466,141943,73103,32585,926343,girithale,13860
3,141693,431991,44222,146137,87358,38710,890111,kanthale,6450
3,137162,456126,43869,144924,66855,33699,882635,mahiyanganaya,3360
3,147102,449663,36000,152765,79000,38018,902548,ampara,5220
3,129763,416682,44756,149373,86744,36134,863452,dehiaththakandiya,8970
3,123861,463965,26497,147360,67336,34504,863523,mahiyanganaya,11610
3,123488,508710,37911,141949,75986,35414,923458,monagala,2790
3,138798,478684,28963,142408,73561,34050,896464,ampara,6750
3,138106,465026,36670,142371,75690,37696,895559,ampara,9720
3,135765,492380,31470,143262,74803,36387,914067,monaragala,10140
3,130912,497229,27902,142629,65444,29193,893309,ampara,5730
3,144040,454227,24150,145801,85117,31348,884683,kanthale,7140
3,139348,457278,41244,138243,72169,33703,881985,ampara,10680
3,134317,440036,41594,144235,81809,38663,880654,dehiaththakandiya,9780
3,123310,440005,44851,144243,75505,31028,858942,mahiyanganaya,13920
3,149227,471302,39350,141970,60303,37953,900105,ampara,8760
3,134427,446827,36608,138965,62319,37089,856235,kanthale,12210
3,145813,426207,36764,145119,83533,37811,875247,ampara,4260
3,127891,444339,42012,147406,78054,34737,874439,nikaweratiya,14760
3,134380,394356,32793,149680,79183,32378,822770,mahiyanganaya,6750
3,149399,426774,43817,145289,88496,31776,885551,monagala,5370
3,141186,436872,31657,149095,68909,37597,865316,ampara,13440
3,140871,493063,32638,150253,84605,32282,933712,bakamuna,3690
3,126838,420922,37575,146365,73829,30654,836183,dehiaththakandiya,10080
3,139160,454686,24573,149787,85323,31341,884870,girithale,5160
3,147867,472175,37535,149723,82594,29805,919699,Kandakatiya,20460
3,128451,488653,24590,139706,83343,36656,901399,kanthale,630
3,140163,403369,44755,141657,86101,33639,849684,mahiyanganaya,3060
3,151377,489382,38157,145742,79888,34388,938934,medirigiriya,3480
3,125883,503463,28431,147202,78842,31394,915215,monaragala,29460
3,140718,494110,25992,152909,75525,31983,921237,morawewa,6570
3,148267,390434,31915,142402,72259,35252,820529,nikaweratiya,5160
3,128071,454661,42737,145073,60639,38665,869846,girithale,13860
3,141815,400547,29342,151404,81285,29911,834304,kanthale,6450
3,131880,471940,34540,138331,74459,37388,888538,mahiyanganaya,3390
3,123854,494418,39953,141892,82300,36498,918915,ampara,5190
3,133822,422573,26372,151581,86593,30174,851115,dehiaththakandiya,9060
3,150976,502204,27681,138636,78630,38610,936737,mahiyanganaya,11640
3,135272,441513,27155,146031,87168,38117,875256,monagala,2820
3,128192,479301,37306,149639,65152,34809,894399,ampara,6900
3,131202,401359,37959,145031,66153,38938,820642,ampara,9600
3,152901,390049,36948,151047,67705,37510,836160,monaragala,10080
3,134862,494370,40009,147530,72855,34932,924558,ampara,5790
3,123620,426640,28987,145643,68047,29717,822654,kanthale,7110
3,123092,399786,32825,142634,76415,30912,805664,ampara,10710
3,148783,429279,25617,145308,84245,31693,864925,dehiaththakandiya,9810
3,128505,501349,25926,141889,61801,30650,890120,mahiyanganaya,14010
3,143576,468264,30059,151070,88800,31959,913728,ampara,8760
3,137521,450262,24849,143661,87237,35413,878943,kanthale,12150
3,143413,453423,36548,149203,88634,31441,902662,ampara,4230
3,142977,414668,39478,150493,65807,37289,850712,nikaweratiya,14670
3,138905,400371,30702,140726,67573,37415,815692,mahiyanganaya,6930
3,148650,508970,29810,141894,73115,36491,938930,monagala,5340
3,151266,419874,24569,152564,64549,29500,842322,ampara,13650
3,147728,458104,39600,142057,84926,33213,905628,bakamuna,3660
3,141261,394171,37127,149193,80205,31888,833845,dehiaththakandiya,10140
3,139025,501400,36963,140366,83053,36017,936824,girithale,5190
3,132047,486203,41342,149447,64348,32776,906163,Kandakatiya,20460
3,144459,407376,29207,139040,70020,34528,824630,kanthale,630
3,135452,401732,32412,147572,86821,35637,839626,mahiyanganaya,2970
3,129685,470352,26534,139875,75061,32611,874118,medirigiriya,3420
3,131681,464371,41120,145606,80270,29863,892911,monaragala,29340
3,141853,442083,37368,149777,78325,35881,885287,morawewa,6780
3,133055,455244,43701,141920,88450,38419,900789,nikaweratiya,5160
3,132629,449240,44026,148680,71615,33523,879713,girithale,13830
3,126067,505080,33220,147045,62078,32178,905668,kanthale,6390
3,131095,416620,32405,139735,84695,31200,835750,mahiyanganaya,3390
3,127010,437648,39046,148714,76215,31191,859824,ampara,5280
3,143749,458314,32941,139813,73905,32239,880961,dehiaththakandiya,8940
3,144862,507794,30396,142528,76634,36596,938810,mahiyanganaya,11400
3,152662,498129,33207,147046,75353,35796,942193,monagala,2850
3,138015,482317,44210,143848,80293,34893,923576,ampara,6840
3,132318,406761,24671,152424,63440,34646,814260,ampara,9630
3,134723,477537,44210,146196,60493,33671,896830,monaragala,10020
3,126427,430044,41158,148597,74201,35951,856378,ampara,5700
3,139116,485830,40607,140844,73664,35453,915514,kanthale,6960
3,128870,433674,25316,150258,85738,29427,853283,ampara,10710
3,142071,440634,28085,146241,72653,33664,863348,dehiaththakandiya,9780
3,147778,401888,35247,139885,87082,37536,849416,mahiyanganaya,14010
3,131114,407535,31633,144951,60308,38600,814141,ampara,8640
3,148754,440199,26327,143651,73779,31907,864617,kanthale,12210
3,126783,462538,38817,139459,62138,38664,868399,ampara,4290
3,147172,497114,35303,147231,62331,32528,921679,nikaweratiya,14580
3,146070,419064,37506,151839,76166,30433,861078,mahiyanganaya,6960
3,124558,488557,34711,145005,82622,29055,904508,monagala,5460
3,151060,479588,41574,140369,67129,31320,911040,ampara,13680
3,142649,419078,43994,144877,69261,31627,851486,bakamuna,3750
3,138874,450299,24317,148250,87728,34204,883672,dehiaththakandiya,10020
3,126445,452404,32526,145141,80922,38417,875855,girithale,5220
3,148091,475531,32220,151036,85222,34856,926956,Kandakatiya,20430
3,149272,488008,39267,147829,86776,32412,943564,kanthale,630
3,127202,430148,42588,147355,82059,33106,862458,mahiyanganaya,2970
3,131182,467956,30332,140402,82849,36557,889278,medirigiriya,3450
3,144179,454639,37280,148058,63327,30382,877865,monaragala,29460
3,133155,408192,40424,151793,84403,32018,849985,morawewa,6510
3,134816,392892,29822,147358,76560,36534,817982,nikaweratiya,5070
3,146957,493650,44947,141127,85671,29282,941634,girithale,13890
3,131287,481840,32997,147120,64140,30916,888300,kanthale,6360
3,151481,425898,36060,147442,67817,31852,860550,mahiyanganaya,3360
3,137466,423332,36841,143779,75518,36081,853017,ampara,5190
3,151891,409685,29629,152832,66270,35622,845929,dehiaththakandiya,9060
3,129542,508228,38021,139235,62557,30761,908344,mahiyanganaya,11640
3,134916,403700,28917,143533,70281,34095,815442,monagala,2880
3,131394,484604,35429,144994,68096,32024,896541,ampara,6720
3,123750,393415,39718,151106,61481,34729,804199,ampara,9600
3,140601,403707,33505,147053,83767,30415,839048,monaragala,10080
3,152471,406142,34791,145040,87109,32025,857578,ampara,5730
3,141764,401805,38999,145119,75271,29156,832114,kanthale,7020
3,125399,421021,36944,149755,70201,30892,834212,ampara,10830
3,127627,402688,41513,149917,85262,32638,839645,dehiaththakandiya,9750
3,125141,399726,36233,149656,79976,37196,827928,mahiyanganaya,14040
3,123889,467698,37773,151668,74797,36124,891949,ampara,8640
3,129549,460836,28499,148732,69667,30310,867593,kanthale,12300
3,129736,489525,29730,143388,68915,31099,892393,ampara,4260
3,127568,397908,38181,143121,87995,36718,831491,nikaweratiya,14580
3,134617,468282,31818,138441,88153,38283,899594,mahiyanganaya,6900
3,149703,413572,38362,145677,66471,38902,852687,monagala,5340
3,124705,469227,26881,148044,67715,31364,867936,ampara,13560
3,142443,443400,37273,140254,77660,35746,876776,bakamuna,3690
3,134432,508392,42512,138136,82697,33660,939829,dehiaththakandiya,10080
3,134096,440001,35102,138858,67966,34336,850359,girithale,5220
3,142578,504669,31308,143674,83097,37542,942868,Kandakatiya,20460
3,152485,437150,24411,149146,78821,38849,880862,kanthale,630
3,138136,413235,25959,146054,88870,33795,846049,mahiyanganaya,3060
3,132099,440227,40398,148279,76930,32139,870072,medirigiriya,3480
3,124439,437916,43698,151300,78983,36964,873300,monaragala,29520
3,134225,478562,34417,148557,63821,36928,896510,morawewa,6510
3,145817,499849,36848,143276,74632,33222,933644,nikaweratiya,5070
3,128806,441952,27632,148712,60938,34132,842172,girithale,13890
3,137807,401755,36565,140743,64170,33042,814082,kanthale,6420
3,128829,462663,35152,152591,71383,30981,881599,mahiyanganaya,3360
3,144736,508879,29846,138475,62582,31489,916007,ampara,5220
3,143308,426651,35976,143125,67443,36010,852513,dehiaththakandiya,9060
3,151772,482963,38089,150008,66291,30245,919368,mahiyanganaya,11400
3,143819,444574,30789,142003,84079,31961,877225,monagala,2790
3,148506,434482,28720,140460,73970,35455,861593,ampara,6840
3,137314,406272,32626,140647,80119,31396,828374,ampara,9600
3,143140,426082,26870,140578,78464,30146,845280,monaragala,10020
3,139037,481283,35476,151820,82708,32133,922457,ampara,5820
3,144679,440297,38839,144405,70698,35015,873933,kanthale,7020
3,135759,418459,38187,146582,67019,34229,840235,ampara,10770
3,151719,431544,27966,150694,76145,36906,874974,dehiaththakandiya,9810
3,149890,454544,41958,150518,71367,36092,904369,mahiyanganaya,13980
3,123054,481393,38645,152525,62574,35048,893239,ampara,8700
3,133787,406071,41659,147086,61180,37464,827247,kanthale,12240
3,152959,494972,34083,146322,82044,36678,947058,ampara,4260
3,131995,508248,42293,140806,70524,34011,927877,nikaweratiya,14580
3,131228,465339,30559,139340,68633,31179,866278,mahiyanganaya,6840
3,137814,497132,41275,146312,85941,36170,944644,monagala,5400
3,130502,499593,30452,148150,69379,31128,909204,ampara,13590
3,147486,507247,31862,145630,82748,34933,949906,bakamuna,3660
3,145533,397805,30831,144886,64718,34404,818177,dehiaththakandiya,10050
3,129700,496947,28753,143808,60760,35471,895439,girithale,5160
3,126598,456927,39291,150889,77817,37743,889265,Kandakatiya,20490
3,139022,503853,26678,151430,88825,32551,942359,kanthale,660
3,144709,449982,24466,149886,68599,36916,874558,mahiyanganaya,2970
3,141490,419675,33538,140714,63917,37177,836511,medirigiriya,3450
3,136602,471062,29181,138882,73563,34302,883592,monaragala,29460
3,134997,410681,42240,145120,80090,34124,847252,morawewa,6540
3,124612,423614,34027,151024,79248,35933,848458,nikaweratiya,5070
3,131984,509218,29647,145400,61761,29312,907322,girithale,13890
3,123416,491526,33343,138965,69377,36164,892791,kanthale,6510
3,128237,410494,44876,152881,66578,29096,832162,anganaya,3390
3,126204,461061,24912,141727,73839,30676,858419,ampara,5160
3,125186,445162,36913,146864,63154,34284,851563,dehiaththakandiya,9090
3,140721,437863,34048,146636,67120,38054,864442,mahiyanganaya,11610
3,129281,469061,43010,147454,69468,37650,895924,monagala,2790
3,131676,392778,35158,141874,75426,33652,810564,ampara,6930
3,131895,413450,38470,146994,69072,38805,838686,ampara,9600
3,135839,498493,44125,146052,63499,32931,920939,monaragala,10050
3,133116,488764,44671,144406,81330,29575,921862,ampara,5730
3,138034,481213,24655,150079,75224,29622,898827,kanthale,7140
3,125057,445883,30811,145408,77002,31409,855570,ampara,10710
3,136915,418380,39758,151947,64950,38130,850080,dehiaththakandiya,9840
3,128634,465056,24547,148634,62839,33410,863120,mahiyanganaya,13980
3,150434,481400,30634,147032,72064,36439,918003,ampara,8700
3,124251,445640,32999,145321,60411,33973,842595,kanthale,12150
3,145725,397594,35817,150464,66238,36617,832455,ampara,4260
3,142967,426203,36558,139231,87890,33165,866014,dehiaththakandiya,7810
3,141374,479792,29999,138649,69746,35518,895078,mahiyanganaya,13250
3,144565,501902,43465,149364,82595,35373,957264,kanthale,12540
3,142207,440142,36589,150919,79262,29881,879000,ampara,6260
3,126068,411316,32842,142787,64594,34624,812231,nikaweratiya,18584
3,145140,501779,42312,146168,82144,35665,953208,mahiyanganaya,9840
3,127236,420803,36911,148380,70174,31483,834987,nikaweratiya,5070
3,148166,484894,28052,151139,72887,33470,918608,girithale,13990
3,148878,418803,42904,140586,75010,37829,864010,kanthale,6440
4,195204,639700,48341,190689,84560,46086,1204580,monaragala,3840
4,194129,529189,54207,186005,106785,38173,1108488,ampara,9252
4,196059,613360,36362,193437,97828,47446,1184492,kanthale,13064
4,194243,623360,37443,200479,110891,38992,1205408,ampara,13440
4,172345,526212,38637,191150,113961,51691,1093996,dehiaththakandiya,7736
4,182030,642110,49875,189696,99413,39922,1203046,mahiyanganaya,9408
4,168813,628572,43805,203104,95498,45786,1185578,ampara,14368
4,185148,534701,58704,199612,92029,38427,1108621,kanthale,13080
4,172120,570843,42341,192052,87653,41723,1106732,ampara,18996
4,192555,574720,34818,196556,81711,44896,1125256,bakamuna,11908
4,196190,565090,43770,198408,82045,40825,1126328,dehiaththakandiya,16504
4,173681,648740,41532,197140,96767,40670,1198530,girithale,5828
4,165109,675146,38447,202352,95787,37511,1214352,Kandakatiya,9472
4,199241,631770,54980,189883,88708,36024,1200606,kanthale,15176
4,187878,559138,56663,196870,96504,40112,1137165,mahiyanganaya,7900
4,189607,532386,47044,203689,103584,40607,1116917,medirigiriya,23852
4,167215,624952,34901,198534,101539,46324,1173465,monaragala,9976
4,177211,568787,47197,193861,88931,48851,1124838,morawewa,18304
4,179321,609561,48005,186701,88731,50434,1162753,nikaweratiya,15444
4,180157,539977,52226,203300,81262,37597,1094519,girithale,8584
4,162051,671209,45160,200433,97904,38882,1215639,kanthale,5468
4,191577,561226,51087,184191,107525,47029,1142635,mahiyanganaya,10628
4,185133,581057,40641,198762,111339,39306,1156238,ampara,17284
4,186533,643881,46992,184218,91901,39268,1192793,bakamuna,11690
4,168366,600648,56683,198170,102464,42041,1168372,girithale,8300
4,160981,553313,34469,191170,112927,51667,1104527,Kandakatiya,9800
4,172000,665082,55660,196087,115934,38335,1243098,kanthale,12890
4,181699,534792,42803,190565,90600,49661,1090120,ampara,15982
4,162718,593963,41350,194059,81381,42634,1116105,dehiaththakandiya,11560
4,170407,654135,57050,197096,80632,48139,1207459,mahiyanganaya,9300
4,188220,520632,34397,197223,103208,41995,1085675,bakamuna,10942
4,172728,562898,42650,192359,99207,50286,1120128,girithale,8750
4,191521,633984,58636,188252,88305,42458,1203156,Kandakatiya,9643
4,176216,564537,55554,201528,104602,39378,1141815,medirigiriya,21130
4,198729,557446,46787,192490,81855,51040,1128347,monaragala,10110
4,195603,549377,58286,186668,105124,45637,1140695,morawewa,19045
4,179202,617025,37922,194691,104246,38464,1171550,nikaweratiya,14988
4,178944,656717,57607,189818,107784,46928,1237798,kanthale,13800
4,197344,551802,46120,202251,104076,37428,1139021,ampara,15476
4,165730,677964,58556,189972,108343,45399,1245964,dehiaththakandiya,12874
4,177054,533465,59749,191048,106969,38449,1106734,mahiyanganaya,11022
4,170687,623730,33555,194237,115695,49878,1187782,kanthale,14362
4,193470,619748,45492,199329,114752,48386,1221177,bakamuna,11510
4,173855,669961,59358,193986,106004,50464,1253628,girithale,8924
4,180166,613829,51060,199464,100447,43349,1188315,Kandakatiya,10285
4,192356,666988,49845,185461,103497,41903,1240050,medirigiriya,22500
4,194511,555605,57771,199245,90178,48132,1145442,monaragala,9898
4,190658,634611,42396,201865,112184,39612,1221326,morawewa,17890
4,180668,575255,54257,189159,81377,38532,1119248,nikaweratiya,14044
4,169349,624650,51148,193217,97045,50470,1185879,kanthale,13350
4,170414,600242,54977,185614,97233,37389,1145869,ampara,16124
4,162547,655012,38082,189672,89936,39455,1174704,dehiaththakandiya,13600
4,168531,541311,35113,189305,106157,45763,1086180,mahiyanganaya,9534
4,196663,620574,48977,188230,106106,42514,1203064,bakamuna,11986
4,188808,662055,50831,186841,87601,42804,1218940,girithale,8200
4,186064,642591,49037,196039,97220,49389,1220340,Kandakatiya,9405
4,189401,569354,40180,202889,82681,38788,1123293,medirigiriya,21000
4,179250,672859,41272,184752,110466,50917,1239516,monaragala,10280
4,179969,572092,32925,189433,108546,51491,1134456,morawewa,18500
4,178533,634960,39524,191332,90146,41398,1175893,nikaweratiya,15200
4,183529,591912,34828,199946,80868,48643,1139726,kanthale,14456
4,183217,530206,33481,202872,97875,50271,1097922,ampara,15872
4,197771,645245,38534,202277,85117,49185,1218129,dehiaththakandiya,12950
4,199679,622678,38654,187934,82083,46434,1177462,mahiyanganaya,10788
4,193253,628229,55259,196675,89196,49152,1211764,bakamuna,11720
4,164544,548566,33190,188897,97202,50412,1082811,girithale,8500
4,190273,605817,50628,201946,85461,42203,1176328,Kandakatiya,10052
4,175113,615185,57866,184240,112067,47735,1192206,medirigiriya,22000
4,179942,588903,40923,187715,99999,39004,1136486,monaragala,9500
4,198609,525636,55746,195727,86959,49996,1112673,morawewa,18110
4,182829,564064,52642,185415,87942,44755,1117647,nikaweratiya,14250
4,177896,599154,57391,202782,110967,39462,1187652,kanthale,13910
4,193804,530072,36559,185069,101822,40122,1087448,ampara,16300
4,199076,538272,56219,192122,115804,48503,1149996,dehiaththakandiya,13090
4,184222,546721,48534,188362,88850,43771,1100460,mahiyanganaya,9815
4,170973,559919,35660,184236,85061,40290,1076139,bakamuna,11144
4,192372,560555,59800,185939,84972,49560,1133198,girithale,9000
4,174410,600426,58446,202687,82574,49355,1167898,Kandakatiya,9800
4,175364,589766,33196,196250,97713,39246,1131535,medirigiriya,21550
4,197740,600121,48886,187244,97465,42765,1174221,monaragala,10320
4,199404,663728,34552,187545,82950,48755,1216934,morawewa,18800
4,198473,541801,33157,196142,101875,50850,1122298,nikaweratiya,15522
4,167336,590564,59413,187138,114025,39505,1157981,kanthale,14700
4,190738,613625,51195,187691,90064,39206,1172519,ampara,15680
4,187869,532037,55129,200012,84786,39680,1099513,dehiaththakandiya,12510
4,172310,526434,48490,184045,81549,45480,1058308,mahiyanganaya,10470
4,176925,601973,36846,197232,85635,43852,1142463,bakamuna,11350
4,193972,547166,37753,187818,111324,47048,1125081,girithale,8700
4,168141,583324,34466,186934,114502,50767,1138134,Kandakatiya,9990
4,169163,637461,48369,186398,94219,42440,1178050,medirigiriya,22700
4,189789,575606,42159,203574,86195,51794,1149117,monaragala,9700
4,189372,654883,45248,186584,114588,36224,1226899,morawewa,17980
4,199393,597856,32564,186145,113523,46476,1175957,nikaweratiya,14690
4,196489,527812,54826,191514,86166,47716,1104523,kanthale,13280
4,168725,675713,32267,197279,106876,42721,1223581,ampara,16050
4,179630,560075,46361,194927,103330,46294,1130617,dehiaththakandiya,13470
4,177017,626515,49025,198071,85204,36690,1172522,mahiyanganaya,10300
4,188311,566747,39132,194779,98215,41312,1128496,bakamuna,12230
4,178709,549317,45775,200642,112919,43508,1130870,girithale,9150
4,184386,536602,47972,194636,112051,41072,1116719,Kandakatiya,10450
4,175700,620194,39578,203071,89713,43504,1171760,medirigiriya,23000
4,186102,576592,49256,203264,94985,48867,1159066,monaragala,9900
4,171870,530589,49085,192387,90093,50025,1084049,morawewa,18250
4,165960,627799,38448,188721,98891,36676,1156495,nikaweratiya,14800
4,177291,612271,33132,198817,102192,51033,1174736,kanthale,13680
4,186019,555713,44623,200304,83607,39222,1109488,ampara,15590
4,192886,632930,52940,203104,88329,39521,1209710,dehiaththakandiya,13110
4,160281,619222,54071,202807,98065,42454,1176900,mahiyanganaya,10910
4,192909,665773,34397,196650,92128,42539,1224396,bakamuna,11820
4,174629,644545,55356,197172,101962,49694,1223358,girithale,8550
4,172645,623586,50949,187343,103380,46765,1184668,Kandakatiya,10120
4,164266,601886,46134,184019,80391,42388,1119084,medirigiriya,22200
4,179265,554668,32655,202821,101190,50671,1121270,monaragala,9600
4,192077,653666,51684,189127,94153,51553,1232260,morawewa,18630
4,195215,571123,52980,202941,107196,42113,1171568,nikaweratiya,15000
4,169821,624086,35775,188151,99420,45287,1162540,kanthale,13750
4,166486,665647,59905,190473,109024,39383,1230918,ampara,15490
4,161369,532623,49782,201190,114416,47189,1106569,dehiaththakandiya,13040
4,198915,651712,57543,194402,82932,41588,1227092,mahiyanganaya,11500
4,192671,612462,44792,193599,99107,48597,1191228,bakamuna,12110
4,177428,666616,59117,184117,92898,45983,1226159,girithale,8350
4,191063,650954,48677,195247,81224,36452,1203617,Kandakatiya,9900
4,160818,599713,42182,185979,84616,43838,1117146,medirigiriya,22450
4,160798,535082,33347,195762,105398,46518,1076905,monaragala,9400
4,198006,647354,46948,196892,107411,50550,1247161,morawewa,18900
4,163351,678818,57272,200015,101237,49860,1250553,nikaweratiya,15150
4,186275,596990,58733,191363,84958,51657,1169976,kanthale,14200
4,160973,650389,58125,199174,80914,44761,1194336,ampara,15730
4,162455,663691,51203,201322,107289,45367,1231327,dehiaththakandiya,12600
4,191843,578329,34705,201968,109133,36804,1152782,mahiyanganaya,10700
4,166707,632664,45996,191347,92679,37403,1166796,bakamuna,11600
4,174155,589447,52200,186042,99075,45321,1146240,girithale,8000
4,193390,568202,58863,187534,82186,51484,1141659,Kandakatiya,9600
4,160752,526885,51456,185363,81467,44327,1050250,medirigiriya,21800
4,194135,544689,52208,186241,100422,44702,1122397,monaragala,10200
4,173811,540918,32516,196966,94424,42425,1081060,morawewa,18220
4,198085,593955,56827,186697,81204,38841,1155609,nikaweratiya,14850
4,179953,618224,46439,191536,84009,43910,1164071,kanthale,14020
4,165025,536163,35907,190647,110131,43663,1081536,ampara,16230
4,168526,566989,40117,193726,108100,41992,1119450,dehiaththakandiya,12930
4,171978,585938,58046,201518,84835,37033,1139348,mahiyanganaya,11050
4,192632,639222,34476,195180,84360,45683,1191553,bakamuna,11200
4,178221,523018,40712,200781,93130,51622,1087484,girithale,8900
4,195422,536701,43107,186598,93957,39392,1095177,Kandakatiya,9700
4,193864,603437,58899,191009,101330,42427,1190966,medirigiriya,21200
4,178657,672279,58578,189254,112832,46395,1257995,monaragala,10000
4,176715,522208,37853,187200,85251,41056,1050283,morawewa,17750
4,178572,664316,57503,188878,90390,40620,1220279,nikaweratiya,14970
4,166985,529382,48316,185507,107670,37318,1075178,kanthale,14520
4,190299,539054,38866,200757,85715,50046,1104737,ampara,15650
4,196604,615454,39704,184514,93514,46606,1176396,dehiaththakandiya,13500
4,183180,644906,46235,189705,80936,45388,1190350,mahiyanganaya,10600
4,169341,545449,55193,193544,80302,47819,1091648,bakamuna,11430
4,169738,557390,40498,186867,83747,47549,1085789,girithale,8550
4,185806,549637,43424,185429,114271,41104,1119671,Kandakatiya,10100
4,186132,564883,50081,184823,80031,45893,1111843,medirigiriya,22600
4,195333,678664,55054,203426,92847,38494,1263818,monaragala,9800
4,176663,563053,33966,191573,96315,39291,1100861,morawewa,18550
4,166624,569048,53020,188013,99425,36012,1112142,nikaweratiya,15300
4,193456,594686,37481,195804,82967,50180,1154574,kanthale,13870
4,197710,638596,52227,200071,82439,48261,1219304,ampara,16400
4,167075,520864,37057,203025,84316,51922,1064259,dehiaththakandiya,13060
4,181281,641916,38000,193386,99461,49450,1203494,mahiyanganaya,10800
4,165416,639688,48655,201899,89880,47954,1193492,bakamuna,12040
4,181277,527638,34940,184816,99704,42443,1070818,girithale,8900
4,165453,531929,49707,200842,106281,47509,1101721,Kandakatiya,9900
4,198442,611267,53452,198035,109767,42604,1213567,medirigiriya,21900
4,175081,673302,37138,200011,85924,50746,1222202,monaragala,9400
4,198065,598407,32145,192859,98531,51254,1171261,morawewa,19000
4,190701,596722,38400,192651,101578,41183,1161235,nikaweratiya,15000
4,182071,647185,45576,192127,113880,39718,1220557,kanthale,14100
4,183821,522707,53402,196497,115105,51341,1122873,ampara,15900
4,195195,612795,45283,198738,83359,51942,1187312,dehiaththakandiya,13370
4,173989,563149,43793,185405,90138,38049,1094523,mahiyanganaya,11220
4,167922,570147,52992,200312,97964,38764,1128101,bakamuna,11780
4,173953,523236,50738,200645,113607,40127,1102306,girithale,8750
4,169242,649730,52188,194353,112470,38319,1216302,Kandakatiya,10000
4,180251,591352,51542,184793,90143,46178,1144259,medirigiriya,22400
4,165697,666732,38175,184244,80200,40094,1175142,monaragala,10120
4,195633,561512,39974,189415,89136,38542,1114212,morawewa,18650
4,178062,604041,54554,201558,102674,50379,1191268,nikaweratiya,15200
4,199308,644501,34012,197067,97113,44113,1216114,kanthale,14420
4,180233,658205,32410,188647,85256,43278,1188029,ampara,16510
4,180696,574176,48415,195640,83631,45840,1128398,dehiaththakandiya,13020
4,193297,595300,37414,198207,108880,50122,1183220,mahiyanganaya,10950
4,184326,577329,35670,197187,92629,42428,1129569,bakamuna,11950
4,165953,544881,54600,194824,104705,42488,1107451,girithale,8600
4,166924,615473,48578,184899,110483,40268,1166625,Kandakatiya,10230
4,193455,668484,56988,188695,104036,46737,1258395,medirigiriya,23050
4,172907,547039,59741,193245,114229,48818,1135979,monaragala,9700
4,174769,645671,33641,186949,95288,49178,1185496,morawewa,18340
4,197466,548242,51116,195691,102054,43262,1137831,nikaweratiya,14830
4,162175,535363,56268,191704,87371,38074,1070955,kanthale,13950
4,191502,542627,43423,200209,99657,49083,1126501,ampara,15760
4,160529,651146,35360,186817,114975,46155,1194982,dehiaththakandiya,12870
4,190939,625064,43064,184133,103429,46651,1193280,mahiyanganaya,11350
4,186599,645476,58573,200503,102846,43093,1237090,bakamuna,11650
4,169569,662997,56566,185279,113776,38138,1226325,girithale,8900
4,179377,566542,53135,200370,97665,50106,1147195,Kandakatiya,9800
4,183380,676162,48814,192637,80356,47435,1228784,medirigiriya,22000
4,190397,540828,43946,195584,92698,39700,1103153,monaragala,9800
4,167124,637710,51816,200439,94854,42783,1194726,morawewa,18200
4,161804,641726,55657,193501,93085,51725,1197498,nikaweratiya,15120
4,187359,648370,35758,198541,83787,43888,1197703,kanthale,13550
4,189841,570808,54168,199604,95555,46364,1156340,ampara,16340
4,187044,524698,55243,201283,99543,49440,1117251,dehiaththakandiya,13250
4,174217,660669,54814,185771,105273,41487,1222231,mahiyanganaya,11000
4,175690,623427,49256,193962,107403,37953,1187691,bakamuna,12210
4,179300,584977,45056,200137,81528,49115,1140113,girithale,8500
4,185044,635457,40395,199605,91717,44360,1196578,Kandakatiya,10000
4,160049,568592,56506,200066,87817,51214,1124244,medirigiriya,22500
4,162071,610179,57525,184519,96077,47390,1157761,monaragala,10100
4,195394,534498,35554,187936,108574,44412,1106368,morawewa,18400
4,189749,544454,46317,193007,85034,48663,1107224,nikaweratiya,15250
4,178261,665606,47481,199708,83998,36108,1211162,kanthale,13700
4,185295,634422,55181,191001,104439,39134,1209472,ampara,16020
4,165223,591069,42004,187765,92454,36680,1115195,dehiaththakandiya,13400
4,199200,574505,52039,185690,105895,43857,1161186,mahiyanganaya,10850
4,161199,571147,50189,190668,102887,47756,1123846,bakamuna,11900
4,172126,539239,52898,199401,106734,42557,1112955,girithale,8400
4,188977,620880,41706,197290,114919,48650,1212422,Kandakatiya,9800
4,179881,658874,59225,188507,103404,45385,1235276,medirigiriya,21850
4,162468,521315,34483,201396,115223,38684,1073569,monaragala,9800
4,171324,585285,43465,201216,91431,49262,1141983,morawewa,18700
4,163196,630851,57242,185244,108466,40327,1185326,nikaweratiya,15070
4,161879,592745,50587,202722,97045,44132,1149110,kanthale,14180
4,177912,552350,41781,189448,85536,42435,1089462,ampara,15780
4,173695,658597,52798,203296,88872,40345,1217603,dehiaththakandiya,13620
4,197400,550175,39872,185680,97553,39078,1109758,mahiyanganaya,10700
4,187469,662554,33790,196888,82379,46402,1209482,bakamuna,11760
4,185753,545818,33704,197222,105184,50952,1118633,girithale,8300
4,165537,627002,50210,193148,83461,50992,1170350,Kandakatiya,9950
4,171940,554483,34186,195848,86746,42470,1085673,medirigiriya,22300
4,195559,580941,36673,198410,92678,44099,1148360,monaragala,9600
4,161528,579608,33984,192885,97930,47373,1113308,morawewa,18100
4,162002,657397,36669,198841,115242,47096,1217247,nikaweratiya,15300
4,179346,584992,32792,193495,100863,39845,1131333,kanthale,14560
4,164235,606872,50297,202699,111538,46331,1181972,ampara,16250
4,184705,605435,53627,203766,80408,50974,1178915,dehiaththakandiya,12980
4,161457,552680,57158,188019,88668,51057,1099039,mahiyanganaya,11140
4,187581,597900,44418,187719,81935,40545,1140098,bakamuna,12030
4,173514,640046,42176,190735,104762,43101,1194334,girithale,8800
4,183198,562704,55365,198938,106897,39124,1146226,Kandakatiya,10400
4,163164,600804,50963,190866,87674,45769,1139240,medirigiriya,22650
4,176376,592930,38733,198248,89443,38595,1134325,monaragala,9700
4,191665,614906,52927,198409,103373,37771,1199051,morawewa,18580
4,174249,644320,37474,188830,82663,43519,1171055,nikaweratiya,14990
4,163311,646560,45122,198292,83276,46944,1183505,kanthale,13820
4,164820,647922,42004,185158,102286,42188,1184378,ampara,16540
4,197609,615748,55475,203768,99204,49310,1221114,dehiaththakandiya,13120
4,171147,664593,32894,198937,91086,40040,1198697,mahiyanganaya,11280
4,166196,569476,47627,187993,105159,45085,1121536,bakamuna,11850
4,173903,589015,34782,199428,86094,40085,1123307,girithale,8950
4,195477,667300,43723,202104,80748,43037,1232389,Kandakatiya,9700
4,176433,583956,56311,202947,96960,42085,1158692,medirigiriya,22050
4,185812,622983,51921,196026,89181,36744,1182667,monaragala,9900
4,176940,661718,38899,192919,97721,41887,1210084,morawewa,18320
4,176396,638480,43940,189453,93826,42417,1184512,nikaweratiya,15080
4,193626,655831,58113,194327,82411,38850,1223158,kanthale,14150
4,195141,667371,51029,194246,108341,44465,1260593,ampara,15890
4,160544,646918,51528,196237,97737,46744,1199708,dehiaththakandiya,13550
4,165416,575768,57852,186547,88008,49825,1123416,mahiyanganaya,10900
4,173986,526654,36833,190367,85929,44480,1058249,bakamuna,12120
4,184346,603892,44177,199841,99871,37461,1169588,girithale,8700
4,163182,563520,59069,197763,100315,36709,1120558,Kandakatiya,10050
4,164006,586915,45406,199213,105392,39627,1140559,medirigiriya,22750
4,184926,678839,55913,188940,108717,39455,1256790,monaragala,9800
4,179737,634448,42082,203468,91678,39599,1191012,morawewa,18680
4,193085,678145,39418,184151,95500,47317,1237616,nikaweratiya,15230
4,178778,641811,38719,190035,100217,48642,1198202,kanthale,14600
4,163806,536960,36202,189024,104557,37454,1068003,ampara,16240
4,161363,567029,57109,185183,109802,51742,1132228,dehiaththakandiya,13380
4,179818,643128,59645,195590,94353,46166,1218700,mahiyanganaya,10600
4,199723,623809,34833,186435,115868,39582,1200250,bakamuna,11560
4,194702,602526,41569,185839,99937,39009,1163582,girithale,8750
4,167954,545730,42926,201105,107028,37524,1102267,Kandakatiya,10120
4,180783,571454,47209,191090,113900,43359,1147795,medirigiriya,21950
4,193348,526842,53419,189825,114433,51770,1129637,monaragala,10050
4,181891,593624,56045,186333,111154,40173,1169220,morawewa,17950
4,194625,609303,38175,193681,98386,44912,1179082,nikaweratiya,14880
4,185797,524754,36005,195527,87400,40967,1070450,kanthale,14300
4,191127,554949,49868,196870,106192,46584,1145590,ampara,15660
4,171641,642788,51777,192411,101741,42149,1202507,dehiaththakandiya,13000
4,170398,592026,54348,191418,97714,49636,1155540,mahiyanganaya,10480
4,178007,660663,49995,195481,94813,36580,1215539,bakamuna,11830
4,190718,553942,41760,192861,111822,38729,1129832,girithale,8550
4,187298,631847,39567,201898,108837,43341,1212788,medirigiriya,22600
4,161015,634672,43114,202921,115919,48671,1206312,monaragala,10200
4,178611,618786,37562,196795,108225,43933,1183912,Kandakatiya,9800
4,177156,571370,42181,185824,85783,40504,1102818,medirigiriya,22350
4,175178,523048,35828,195236,87338,40076,1056704,monaragala,9900
4,184565,607257,45884,188216,107389,49004,1182315,morawewa,18750
4,171961,672284,52002,196194,98125,46557,1237123,nikaweratiya,15020
4,171089,528618,41670,185716,101020,36212,1064325,kanthale,13840
4,198080,664449,42427,194913,97255,43838,1240962,ampara,16000
4,188454,596392,55054,200119,86520,50502,1177041,dehiaththakandiya,12910
4,179557,651110,53595,198083,100210,48691,1231246,mahiyanganaya,10820
4,197878,677622,39860,193722,101239,40684,1251005,bakamuna,12140
4,195349,531081,50184,199270,115148,39610,1130642,girithale,8900
4,198322,545533,33533,187249,111463,44316,1120416,Kandakatiya,9700
